132
8
31 31 33 34 33 34 33 4 0 0 0 0 0 0 0 0 0 0 0 0 0 0 0 0 0 0 0 0 0 0 0 0 0 0 0 0 0 0 0 0 0 0 0 0 0 3 33 4 0 0 0 0 0 0 0 0 0 0 0 0 0 0 0 0 0 0 0 0 0 0 0 0 0 0 0 0 0 0 0 0 0 0 0 0 0 0 0 0 0 0 0 0 0 0 0 0 0 0 0 0 0 0 0 0 0 0 0 0 0 0 0 0 0 0 0 0 0 0 0 0 0 0 0 0 0 37 37 37 31 30 30 31 
32 32 30 0 35 0 35 0 0 0 0 0 0 0 0 0 0 0 0 0 0 0 0 0 0 0 0 0 0 0 0 0 0 0 0 0 0 0 0 0 0 0 0 0 0 0 35 0 0 0 0 0 0 0 0 0 0 0 0 0 0 0 0 0 0 0 0 0 0 0 0 0 0 0 0 0 0 0 0 0 0 0 0 0 0 0 0 0 0 0 0 0 0 0 0 0 0 0 0 0 0 30 0 0 0 0 0 0 0 0 0 0 0 0 0 0 0 0 0 0 0 0 0 0 0 37 37 37 32 31 32 32 
30 31 30 30 32 0 35 0 0 0 0 0 0 0 0 0 0 0 0 0 0 0 32 33 0 0 0 0 6 6 0 6 0 0 0 0 0 0 0 0 0 0 0 0 0 0 35 0 0 0 0 0 0 0 0 0 0 0 0 0 0 0 0 0 0 0 3 33 4 0 31 31 31 31 31 31 31 0 0 0 0 0 0 0 0 0 0 0 0 0 0 0 0 0 0 0 0 0 0 32 30 30 0 0 0 3 33 4 0 0 0 0 0 0 0 0 0 0 0 0 0 0 0 0 0 37 37 37 32 30 32 30 
30 32 31 32 32 32 31 4 0 3 39 39 4 0 0 0 0 0 0 0 0 32 30 35 0 0 0 0 6 6 38 6 38 0 0 39 39 0 0 0 0 0 0 0 0 0 35 0 0 0 0 0 0 0 0 0 0 0 0 0 0 0 3 33 4 0 0 35 0 0 0 0 0 0 0 0 0 0 0 0 0 0 38 0 39 39 0 0 0 0 0 0 0 0 0 0 0 0 32 32 30 0 0 0 0 0 35 0 0 0 3 33 4 0 0 0 0 0 0 0 0 0 0 0 0 37 37 37 31 30 32 32 
31 30 31 32 31 32 31 4 0 0 0 0 0 0 0 0 0 0 0 0 32 31 32 35 0 0 0 0 6 6 37 6 37 6 6 6 0 0 0 0 0 0 0 0 0 0 35 0 0 0 0 0 0 0 0 0 0 0 0 0 0 0 0 35 0 0 0 35 0 0 0 0 0 0 0 0 0 0 38 0 0 0 37 0 0 0 0 0 0 0 0 0 0 0 0 0 0 32 32 30 0 0 38 0 0 0 35 0 0 0 0 35 0 0 0 0 0 0 0 0 0 0 0 0 0 37 37 37 31 32 32 32 
39 39 39 39 39 39 39 4 0 0 0 0 0 0 0 33 4 3 40 33 34 33 34 35 5 41 3 33 4 6 37 6 37 6 6 6 0 0 0 0 0 0 0 0 0 0 0 0 0 0 3 34 34 34 34 34 33 34 33 4 0 0 0 35 0 0 0 35 0 0 3 33 34 33 4 0 0 0 37 0 0 0 37 0 0 0 0 0 3 33 34 33 34 33 4 0 32 32 30 0 0 0 38 0 0 3 33 4 0 0 0 35 0 0 0 0 0 0 0 0 0 0 0 0 0 37 37 37 32 32 31 32 
2 2 2 2 2 2 5 0 0 0 0 0 0 0 0 35 6 0 0 35 0 35 0 35 0 41 0 35 6 6 37 6 37 6 6 6 6 0 40 40 40 32 32 30 31 0 0 0 0 0 0 0 0 0 0 0 35 0 35 0 0 0 0 35 0 0 0 35 0 0 0 35 0 35 3 33 4 3 33 4 0 0 37 0 0 0 0 0 0 35 0 35 0 30 32 31 30 32 32 30 31 32 36 0 0 0 35 0 0 0 3 33 4 0 0 0 0 0 0 32 32 31 30 31 32 37 37 37 30 31 30 32 
32 31 32 32 32 30 32 32 32 32 31 32 32 32 31 35 6 6 6 35 0 35 0 35 0 41 0 35 6 6 36 6 36 6 6 6 6 6 6 6 6 32 31 32 31 3 4 3 4 32 31 32 30 31 31 32 35 0 35 0 0 0 0 35 0 0 0 35 0 0 0 35 0 35 0 35 0 0 35 0 0 0 36 0 31 31 0 0 0 35 0 30 31 32 32 31 32 32 30 32 30 32 32 32 32 32 35 0 0 0 0 35 0 0 0 0 0 32 30 32 31 31 32 32 31 36 36 36 32 30 32 31 
